1 1 1 1 1 1 1 1 1 1 1 1 1 1 1 1 1 1 1 1 1 1 1
14 0 0 0 0 0 0 0 0 0 0 0 0 0 0 0 0 0 0 0 0 0 1 
14 0 0 2 2 2 2 2 2 2 2 2 2 2 2 2 2 2 2 2 2 0 1 
14 0 0 0 0 0 0 0 0 0 0 0 0 0 0 0 0 0 0 0 2 0 1 
14 0 0 2 2 2 2 2 2 2 2 2 2 2 2 2 2 2 2 0 2 0 1 
14 0 0 2 0 0 0 0 0 0 0 0 0 0 0 0 0 0 2 0 2 0 1 
14 0 0 2 0 2 2 2 2 2 2 2 2 2 0 0 0 0 2 0 2 0 1 
14 0 0 2 0 2 0 0 0 0 2 2 2 2 0 0 0 0 2 0 2 0 1 
14 0 0 2 0 2 0 0 0 2 2 2 2 2 0 0 0 0 2 0 2 0 1 
14 0 0 2 0 2 0 0 0 2 2 2 2 2 0 0 0 0 2 0 2 0 1 
14 0 0 2 0 2 0 0 0 2 2 2 2 2 0 0 0 0 2 0 2 0 1 
14 0 0 2 0 2 0 0 0 0 2 2 2 0 0 0 0 0 2 0 2 0 1 
14 0 0 2 0 2 0 0 0 0 0 0 0 0 0 0 0 0 2 0 2 0 1 
14 0 0 2 0 2 0 0 0 0 0 0 0 0 0 0 0 0 2 0 2 0 1 
14 0 0 2 0 2 0 0 0 0 0 0 0 0 0 0 0 0 2 0 2 0 1 
14 0 0 2 0 2 0 0 0 0 0 0 0 0 0 0 0 0 2 0 2 0 1 
14 0 0 2 0 2 0 0 0 0 0 0 0 0 0 0 0 0 2 0 2 0 1 
14 0 0 2 0 2 2 2 2 2 2 2 2 2 2 2 2 2 2 0 2 0 1 
14 0 0 2 0 0 0 0 0 0 0 0 0 0 0 0 0 0 0 0 2 0 1 
14 0 0 2 2 2 2 2 2 2 2 2 2 2 2 2 2 2 2 2 2 0 1
14 0 0 0 0 0 0 0 0 0 0 0 0 0 0 0 0 0 0 0 0 0 1
14 0 0 0 0 0 0 0 0 0 0 0 0 0 0 0 0 0 0 0 0 0 1
14 0 0 0 0 0 0 0 0 0 0 0 0 0 0 0 0 0 0 0 0 0 1
14 0 0 0 0 0 0 0 0 0 0 0 0 0 0 0 0 0 0 0 0 0 1
14 0 0 0 0 0 0 0 0 0 0 0 0 0 0 0 0 0 0 0 0 0 1
14 0 0 0 0 0 0 0 0 0 0 0 0 0 0 0 0 0 0 0 0 0 1
14 0 0 0 0 0 0 0 0 0 0 0 0 0 0 0 0 0 0 0 0 0 1
14 0 0 0 0 0 0 0 0 0 0 0 0 0 0 0 0 0 0 0 0 0 1
14 0 0 0 0 0 40 0 0 0 S 0 0 0 0 0 0 0 0 0 0 0 1
1 0 0 0 0 0 0 0 0 0 0 0 0 0 0 0 0 0 0 0 0 0 1
1 0 0 0 0 0 0 0 0 0 0 0 0 0 0 0 0 0 0 0 0 0 1
1 0 0 0 0 0 0 0 0 0 0 0 0 0 0 0 0 0 0 0 0 0 1
1 0 0 0 0 0 0 0 0 0 0 0 0 0 0 0 0 0 0 0 0 0 1
1 0 0 0 0 0 0 0 0 0 0 0 0 0 0 0 0 0 0 0 0 0 1
1 0 0 0 0 0 0 0 0 0 0 0 0 0 0 0 0 0 0 0 0 0 1
1 1 2 3 4 5 6 0 0 0 0 0 0 0 8 7 6 5 4 3 2 1 1
1 1 1 1 1 1 1 1 0 0 0 0 0 0 1 1 1 1 1 1 1 1 1
1 1 1 1 1 1 1 1 1 -1 -1 -1 -1 1 1 1 1 1 1 1 1 1 1
1 1 1 1 1 1 1 1 0 0 0 0 0 0 1 1 1 1 1 1 1 1 1
1 1 1 1 1 1 1 0 0 0 0 0 0 0 0 1 1 1 1 1 1 1 1
1 1 1 1 1 1 0 0 0 0 0 0 0 0 0 0 1 1 1 1 1 1 1
1 1 1 1 1 0 0 0 0 0 0 0 0 0 0 0 0 1 1 1 1 1 1
1 1 1 1 0 0 0 0 0 0 0 0 0 0 0 0 0 0 1 1 1 1 1
1 1 1 1 0 0 0 0 0 0 0 0 0 0 0 0 0 0 1 1 1 1 1
1 1 1 1 0 0 0 0 0 0 0 0 0 0 0 0 0 0 1 1 1 1 1
1 1 1 1 0 0 0 0 0 0 0 0 0 0 0 0 0 0 1 1 1 1 1
1 1 1 1 0 0 0 0 0 0 0 0 0 0 0 0 0 0 1 1 1 1 1
1 1 1 1 1 0 0 0 0 0 0 0 0 0 0 0 0 1 1 1 1 1 1
1 1 1 1 1 1 1 0 0 0 0 0 0 0 0 1 1 1 1 1 1 1 1
1 1 1 1 1 1 1 1 0 0 0 0 0 0 1 1 1 1 1 1 1 1 1
1 1 1 1 1 1 1 1 1 1 1 1 1 1 1 1 1 1 1 1 1 1 1
