7 1 1 1 1 1 1 1 1 1 1 1 1 1 1 1 1 1 1
7 0 0 0 0 0 0 0 0 0 0 0 0 0 0 0 0 0 5
7 0 0 0 0 0 0 0 0 0 0 0 0 0 0 0 0 0 5
7 0 0 0 0 0 0 0 0 0 0 0 0 0 0 0 0 0 5
7 0 0 0 0 0 0 0 0 0 0 0 0 0 0 0 0 0 5
7 0 0 0 0 0 0 0 0 0 0 0 0 0 0 0 0 0 5
7 0 0 0 0 0 0 0 0 0 0 0 0 0 0 0 0 0 5
7 0 0 0 0 0 0 0 0 0 0 0 0 0 0 0 0 0 5
7 0 0 0 0 0 0 0 0 0 0 0 0 0 -1000000 0 0 0 5
7 0 0 0 0 0 0 0 0 0 0 0 0 0 0 0 0 0 5
7 0 0 0 0 0 0 0 0 0 0 0 0 0 0 0 0 0 5
7 0 0 0 0 0 0 0 0 0 0 0 0 0 0 0 0 0 5
7 0 0 0 0 0 0 0 0 0 0 0 0 0 0 0 0 0 5
7 0 0 0 0 0 0 0 0 0 0 0 0 0 0 0 0 0 5
7 0 0 0 0 0 0 0 0 0 0 S 0 0 0 0 0 0 5
7 0 0 0 0 0 0 0 0 0 0 0 0 0 0 0 0 0 5
7 0 0 0 0 0 0 0 0 0 0 0 0 0 0 0 0 0 5
7 1 2 3 4 5 6 7 8 9 8 7 6 5 4 3 2 1 1