4  4  4  4  4  4  4  4  4  4  4  4  4  4  4
4  0  0  0  0  0  0  0  0  0  0  0  0  0  4
4  0 14  0 14  0 14  0 14  0 14  0 14  0  4
4  0  0  0  0  0  0  0  0  0  0  0  0  0  4
4  0 14  0 14  0 14  0 14  0 14  0 14  0  4
4  0  0  0  0  0  0  0  0  0  0  0  0  0  4
4  0 14  0 14  0 14  0 14  0 14  0 14  0  4
4  0  0  0  0  0  0  0  0  0  0  0  0  0  4
4  0 14  0 14  0 14  0 14  0 14  0 14  0  4
4  0  0  0  0  0  0  0  0  0  0  0  0  0  4
4  0 14  0 14  0 14  0 14  0 14  0 14  0  4
4  0  0  0  0  0  0  0  0  0  0  0  0  0  4
4  0 14  0 14  0 14  0 14  0 14  0 14  0  4
4  0  0  0  0  0  0  0  0  0  0  0  0  0  4
4  0 14  0 14  0 14  0 14  0 14  0 14  0  4
4  0  0  0  0  0  0  0  0  0  0  0  0  0  4
4  0 14  0 14  S 14  0 14  0 14  0 14  0  4
4  0  0  0  0  0  0  0  0  0  0  0  0  0  4
4  0 14  0 14  0 14  0 14  0 14  0 14  0  4
4  0  0  0  0  0  0  0  0  0  0  0  0  0  4
4  0 14  0 14  0 14  0 14  0 14  0 14  0  4
4  0  0  0  0  0  0  0  0  0  0  0  0  0  4
4  0 14  0 14  0 14  0 14  0 14  0 14  0  4
4  0  0  0  0  0  0  0  0  0  0  0  0  0  4
4  0 14  0 14  0 14  0 14  0 14  0 14  0  4
4  0  0  0  0  0  0  0  0  0  0  0  0  0  4
4  0 14  0 14  0 14  0 14  0 14  0 14  0  4
4  0  0  0  0  0  0  0  0  0  0  0  0  0  4
4  4  4  4  4  4  4  4  4  4  4  4  4  4  4
